11111110
00000011
11000001
01100001
00100011
00111110